###############################################
#                          !                  #
#                                             #
#                   +                         #
#     !                                       #
#                                             #
#                         #####     !         #
#                         #   #               #
#                              #              #
#            $                                #
#                   +   !   !                 #
#                                             #
#  +                                          #
#                  %                 %        #
#                                             #
###############################################